NO textures/bluestone.xpm
SO textures/greystone.xpm
WE textures/purplestone.xpm
EA textures/redbrick.xpm
F 220,100,0
C 225,30,0

        1111111111111111111111111
        1000000000000000000000001
        1100000000000000000000001
        1000000000000000000000001
111111111000000000000000000000001
100000000000000000000000000001111
10000000000000000100000000001
10000000000000000000000000001
10000000000000000000000000001
10000000000000000000000000001
100000000000000N0001010000001
11000001110101011111011110101
11110111 1110111 101111010001
11111111 1111111 111111111111