NO ./textures/bluestone.xpm
SO ./textures/redbrick.xpm
WE ./textures/wood.xpm
EA ./textures/eagle.xpm
F 135,206,250
C 139,0,19

1111111111111111111
1000000010000000001
1000000010000000001
1000000010000000001
100000001N000000001
1000000010000000001
1111111111111111111